#####
#S  #
# # #
#  E#
#####